-4,247,1484,249,248,490,-1
-3,119,708,118,116,1180,3
-3,123,738,124,122,1240,1
-3,193,1158,194,190,382,3
-3,224,1338,223,222,440,2
-2,125,760,129,128,1290,-3
-2,215,1297,218,217,432,-2
-1,113,674,112,114,1120,-1
-1,137,827,139,136,1390,1
-1,141,851,143,140,1430,1
-1,208,1241,206,207,410,1
1,134,793,130,133,1300,1
1,155,940,158,156,1580,-1
1,166,1000,167,169,1670,-3
1,184,1096,181,183,364,1
1,195,1180,198,196,398,-1
1,202,1207,200,203,402,-1
1,225,1360,228,226,458,-1
2,106,635,105,108,1050,-2
2,150,905,151,154,1510,-4
2,187,1121,186,185,376,2
2,214,1277,211,212,426,2
2,231,1391,232,233,468,-2
3,161,966,160,164,1600,-3
3,235,1416,236,238,478,-3
3,244,1455,240,241,486,3
4,102,610,100,101,1000,1
4,147,880,145,148,1450,-1
4,172,1030,170,171,1700,1
4,176,1057,175,178,358,-2
