-4,2,151,1,1510,150,455
-3,-2,129,4,1290,125,385
-3,1,167,1,1670,166,502
-3,3,160,-1,1600,161,483
-3,3,236,1,478,235,711
-2,-2,218,3,432,215,652
-2,2,105,-1,1050,106,317
-2,2,232,1,468,231,698
-2,4,175,-1,358,176,529
-1,-4,249,2,490,247,743
-1,-1,112,-1,1120,113,335
-1,1,158,3,1580,155,475
-1,1,198,3,398,195,595
-1,1,200,-2,402,202,601
-1,1,228,3,458,225,685
-1,4,145,-2,1450,147,439
1,-3,124,1,1240,123,369
1,-1,139,2,1390,137,416
1,-1,143,2,1430,141,428
1,-1,206,-2,410,208,617
1,1,130,-4,1300,134,391
1,1,181,-3,364,184,544
1,4,100,-2,1000,102,304
1,4,170,-2,1700,172,514
2,-3,223,-1,440,224,666
2,2,186,-1,376,187,560
2,2,211,-3,426,214,635
3,-3,118,-1,1180,119,351
3,-3,194,1,382,193,579
3,3,240,-4,486,244,723
