101,-2,555,0,1529,103,102
108,-1,333,0,1612,109,107
114,4,111,0,1680,110,112
116,-1,333,0,1757,117,117
122,2,333,0,1826,120,122
128,2,333,0,1902,126,127
133,1,444,0,1985,132,132
136,1,111,0,2046,135,137
140,-4,111,0,2131,144,142
148,2,555,0,2202,146,147
154,2,333,0,2281,152,152
156,-1,555,0,2349,157,157
164,2,333,0,2432,162,162
169,4,333,0,2501,165,167
171,-2,555,0,2579,173,172
178,1,555,0,2654,177,177
183,3,333,0,2728,180,182
185,-4,444,0,2806,189,187
190,-2,444,0,2878,192,192
196,-1,555,0,2949,197,197
203,-1,222,0,3039,204,202
207,-2,111,0,3114,209,207
212,2,222,0,3175,210,212
217,-2,333,0,3260,219,217
222,1,444,0,3331,221,222
226,-1,555,0,3399,227,227
233,3,555,0,3473,230,232
238,1,555,0,3553,237,237
241,-1,222,0,3629,242,242
248,2,444,0,3706,246,247
