121,1.0,124,369,1,-3
127,-3.0,129,385,4,-2
138,1.0,139,416,2,-1
142,1.0,143,428,2,-1
153,,151,455,1,2
159,,158,475,3,1
168,,167,502,1,1
191,3.0,194,579,1,-3
199,-1.0,198,595,3,1
216,-2.0,218,652,3,-2
229,-1.0,228,685,3,1
234,-2.0,232,698,1,2
245,-1.0,249,743,2,-4
