104,1529,100,1000,103,4
107,1612,105,1050,109,2
111,1680,112,1120,110,-1
115,1757,118,1180,117,-3
121,1826,124,1240,120,-3
127,1902,129,1290,126,-2
131,1985,130,1300,132,1
138,2046,139,1390,135,-1
142,2131,143,1430,144,-1
149,2202,145,1450,146,4
153,2281,151,1510,152,2
159,2349,158,1580,157,1
163,2432,160,1600,162,3
168,2501,167,1670,165,1
174,2579,170,1700,173,4
179,2654,175,358,177,4
182,2728,181,364,180,1
188,2806,186,376,189,2
191,2878,194,382,192,-3
199,2949,198,398,197,1
201,3039,200,402,204,1
205,3114,206,410,209,-1
213,3175,211,426,210,2
216,3260,218,432,219,-2
220,3331,223,440,221,-3
229,3399,228,458,227,1
234,3473,232,468,230,2
239,3553,236,478,237,3
243,3629,240,486,242,3
245,3706,249,490,246,-4
