101,102,100,1014,-2,444
108,106,105,1067,-1,333
114,113,112,1130,-1,222
116,119,118,1172,-1,222
122,123,124,1226,1,222
128,125,129,1272,4,222
133,134,130,1325,-4,333
136,137,139,1371,2,222
140,141,143,1411,2,222
148,147,145,1472,-2,444
154,150,151,1521,1,333
156,155,158,1564,3,333
164,161,160,1622,-1,444
169,166,167,1676,1,333
171,172,170,1714,-2,444
178,176,175,1769,-1,444
183,184,181,1828,-3,333
185,187,186,1861,-1,333
190,193,194,1918,1,222
196,195,198,1964,3,333
203,202,200,2019,-2,333
207,208,206,2069,-2,222
212,214,211,2125,-3,333
217,215,218,2165,3,222
222,224,223,2226,-1,222
226,225,228,2264,3,333
233,231,232,2323,1,333
238,235,236,2368,1,444
241,244,240,2419,-4,444
248,247,249,2476,2,111
