112,-1,110,114,111,2,0
124,-3,120,122,121,4,0
130,1,132,133,131,6,0
139,-1,135,136,138,7,0
145,4,146,148,149,9,0
151,2,152,154,153,10,0
160,3,162,164,163,12,0
167,1,165,169,168,13,0
175,4,177,178,179,15,0
181,1,180,183,182,16,0
211,2,210,212,213,22,0
223,-3,221,222,220,24,0
232,2,230,233,234,26,0
236,3,237,238,239,27,0
249,-4,246,248,245,29,0
