112,0,-1,-1,1130,113,111
124,0,1,1,1226,123,121
129,0,-3,4,1272,125,127
130,0,1,-4,1325,134,131
139,0,1,2,1371,137,138
145,0,-1,-2,1472,147,149
151,0,-4,1,1521,150,153
160,0,-3,-1,1622,161,163
167,0,-3,1,1676,166,168
175,0,-2,-1,1769,176,179
181,0,1,-3,1828,184,182
211,0,2,-3,2125,214,213
223,0,2,-1,2226,224,220
232,0,-2,1,2323,231,234
236,0,-3,1,2368,235,239
249,0,-1,2,2476,247,245
