1529,-2,104,4,100,555
1757,-1,115,-3,118,333
1826,2,121,-3,124,333
1985,1,131,1,130,444
2046,1,138,-1,139,111
2131,-4,142,-1,143,111
2579,-2,174,4,170,555
2728,3,182,1,181,333
2806,-4,188,2,186,444
2878,-2,191,-3,194,444
3114,-2,205,-1,206,111
3175,2,213,2,211,222
3331,1,220,-3,223,444
3629,-1,243,3,240,222
